1111111111
10100E0001
10P1110C01
1000C00001
1111111111
